11111111111111111111111111111
10100101001000001010010000001
10100100101010100010010000001
101000000C00C000000C000000P01
1E1000000000000C00000C0000001
1000010100100C001010010000001
10100100101010100010010000001
1C1000000C00100C00000C0000001
11000000010000000000010000001
1000000001000000000001000C001
10000000010000000000010000001
100000C001000000000C010000001
10010010010010000100010001001
11111111111111111111111111111