11111111111111
10100101001001
100000000C0001
1E1000000000P1
10100100101011
11111111111111